5555555555555555555555555555
5004444444444004444444444005
5004444444444004444444444005
5444400111111001111110044445
5444400111111001111110044445
5444400110011001100110044445
5444400110011001100110044445
5444400111111001100110044445
5444400111111001100110044445
5444400000011001100110044445
5444400000011001100110044445
5444400111111001111110044445
5444400111111001111110044445
5444444444444444444444444445
5444444444444444444444444445
5550000000000550000000000555
5550000000011551100000000555
5220000000011111100000000225
5221100110011111100110011225
5221155115511111155115511225
5221155115511111155115511225
5221100110011001100110011225
5221100110000000000110011225
5221100110000000000110011225
5221100110001111000110011225
5444444000001901000002222225
5444444000001001000002222225
5555555555555555555555555555